1111111111111111111111111111111111
1E0000000000000C00000C000000000001
1010010100100000101001000000010101
1010010010101010001001000000010101
1P0000000C00C0000000000000000000C1
10000000100C1000001000000000000001
100000C100000000000010000000E00001
1111C01000000100000001000000000101
1111111111111111111111111111111111
