1111111111111
10E1000000001
10C0011111001
10P0110000001
1111111111111
